kind,label,min,q1,med,q3,max,mean
A,a,26,52,78,104,130,78
A,b,58,112,168,226,282,166
A,c,42,66,99,141,174,90
A,d,27,50,75,102,127,73
A,e,50,84,126,176,218,118
B,a,43,78,117,160,199,113
B,b,37,60,90,127,157,83
B,c,49,88,132,181,225,127
B,d,57,102,153,210,261,147
B,e,64,116,174,238,296,168
